A:4;4;W;4;S;4;E;4;N

a:0;0
b:0;0
c:1;0
d:1;0
e:2;0

21;13
1;2
1;5
21;7
6;
9;
8;

#####################
#B.=.....*......a...#
#..=................#
#..=.....*...b......#
#..=................#
#..=.....*......c...#
#..=..........d.....#
#..=.....*..........#
#..=..........e.....#
#..=................#
#..====..*..========#
#.......@P.........D#
#####################