A:4;4;W;4;S;4;E;4;N

a:0;0
b:0;0
c:0;0
d:1;0
e:1;0

21;13
1;2
1;4
21;8
5;
10;
9;

#####################
#B.=.....*......a...#
#..=................#
#..=.....*...b......#
#..=................#
#..=.....*......c...#
#..=..........d.....#
#..=.....*..........#
#..=..........e.....#
#..=................#
#..====..*..========#
#.......@P.........D#
#####################