A:1;6;E;6;W
B:1;6;N;6;S

a:0;0
b:0;0
c:1;0
d:1;0
e:0;1
f:0;1
g:0;1
h:0;1

21;12;0;0

#####################
#..a.......b........#
#.....*..*...*...*..#
#..c.......d........#
#.....*..*...*...*..#
#...................#
#...e..f....g...h...#
#...................#
#...................#
#........B..........#
#........P..........#
#####################