A:1;6;E;6;W
B:1;6;N;6;S

a:0;0
b:0;0
c:1;0
d:1;0
e:0;1
f:0;1
g:1;1
h:1;1

21;12
1;2
0;4
0;8
5;
10;
9;

#####################
#..a.....D.b........#
#.....*..*...*...*..#
#..c.......d........#
#.....*..*...*...*..#
#...................#
#...e..f....g...h...#
#...................#
#...................#
#........B..........#
#........P..........#
#####################