A:1;5W;

a:1;1
b:1;1
c:2;1
d:2;1
e:3;1

10;10;3;1;3

##########
#..*....B#
#..==....#
#*.=..b..#
#...@....#
#.....c..#
#......a.#
#......*.#
#...P....#
##########